Code département,département,numéro commune,commune,Inscrits,Votants,Exprimés,MITTERRAND (PS),CHIRAC (RPR)
01,AIN,4,AMBERIEU-EN-BUGEY,6295,5058,4875,2762,2113
01,AIN,33,BELLEGARDE-SUR-VALSERINE,5977,4735,4591,2597,1994
01,AIN,53,BOURG-EN-BRESSE,22009,18611,18006,9464,8542
01,AIN,283,OYONNAX,10796,8764,8413,4145,4268
02,AISNE,168,CHATEAU-THIERRY,8748,6856,6596,3768,2828
02,AISNE,173,CHAUNY,8464,6804,6530,4023,2507
02,AISNE,381,HIRSON,7484,6159,5874,3756,2118
02,AISNE,408,LAON,16391,13476,13058,7598,5460
02,AISNE,691,SAINT-QUENTIN,37387,32037,30805,19232,11573
02,AISNE,722,SOISSONS,17096,13721,13291,7789,5502
02,AISNE,738,TERGNIER,8549,7196,6894,4896,1998
03,ALLIER,82,COMMENTRY,6134,4892,4682,3233,1449
03,ALLIER,95,CUSSET,10000,8424,8067,4646,3421
03,ALLIER,185,MONTLUCON,31623,26106,24959,15365,9594
03,ALLIER,190,MOULINS,14516,12010,11569,6072,5497
03,ALLIER,310,VICHY,19866,16125,15563,6390,9173
03,ALLIER,321,YZEURE,9458,8004,7606,4521,3085
04,ALPES-DE-HAUTE-PROVENCE,70,DIGNE-LES-BAINS,10405,8709,8374,4296,4078
04,ALPES-DE-HAUTE-PROVENCE,112,MANOSQUE,13192,11119,10657,5296,5361
05,HAUTES-ALPES,23,BRIANCON,6649,5490,5261,2593,2668
05,HAUTES-ALPES,61,GAP,21201,18134,17447,8621,8826
06,ALPES-MARITIMES,4,ANTIBES,44493,37163,36043,12919,23124
06,ALPES-MARITIMES,12,BEAUSOLEIL,9341,7578,7371,3183,4188
06,ALPES-MARITIMES,27,CAGNES-SUR-MER,25688,21196,20510,7536,12974
06,ALPES-MARITIMES,29,CANNES,48488,41267,40104,14796,25308
06,ALPES-MARITIMES,30,LE CANNET,26410,21516,20891,7864,13027
06,ALPES-MARITIMES,69,GRASSE,23556,19916,19248,8153,11095
06,ALPES-MARITIMES,79,MANDELIEU-LA-NAPOULE,10637,9210,8959,3138,5821
06,ALPES-MARITIMES,83,MENTON,19534,16861,16263,6826,9437
06,ALPES-MARITIMES,85,MOUGINS,7941,6949,6741,2163,4578
06,ALPES-MARITIMES,88,NICE,232818,185888,180010,75463,104547
06,ALPES-MARITIMES,104,ROQUEBRUNE-CAP-MARTIN,8777,7137,6955,2527,4428
06,ALPES-MARITIMES,123,SAINT-LAURENT-DU-VAR,15163,12802,12363,5075,7288
06,ALPES-MARITIMES,155,VALLAURIS,14204,11862,11469,4992,6477
06,ALPES-MARITIMES,157,VENCE,9815,8041,7802,2876,4926
07,ARDECHE,10,ANNONAY,12327,10043,9695,5454,4241
07,ARDECHE,19,AUBENAS,7375,6271,6065,2727,3338
07,ARDECHE,102,GUILHERAND-GRANGES,6975,5962,5752,2946,2806
07,ARDECHE,186,PRIVAS,5903,4958,4759,2368,2391
07,ARDECHE,324,TOURNON-SUR-RHONE,6260,5220,5074,2598,2476
08,ARDENNES,105,CHARLEVILLE-MEZIERES,31700,25834,24950,15087,9863
08,ARDENNES,363,REVIN,5454,4504,4357,3031,1326
08,ARDENNES,409,SEDAN,12265,9875,9578,5860,3718
09,ARIEGE,122,FOIX,6151,5409,5220,3273,1947
09,ARIEGE,225,PAMIERS,9225,7998,7749,4495,3254
10,AUBE,81,LA CHAPELLE-SAINT-LUC,7509,5694,5477,3510,1967
10,AUBE,323,ROMILLY-SUR-SEINE,10641,8398,7954,5113,2841
10,AUBE,333,SAINT-ANDRE-LES-VERGERS,7708,6423,6181,3332,2849
10,AUBE,362,SAINTE-SAVINE,7082,5737,5511,3120,2391
10,AUBE,387,TROYES,34778,27007,26062,13929,12133
11,AUDE,69,CARCASSONNE,27590,23915,23104,12847,10257
11,AUDE,76,CASTELNAUDARY,7639,6714,6486,3493,2993
11,AUDE,206,LIMOUX,6650,5811,5575,3368,2207
11,AUDE,262,NARBONNE,29145,24601,23525,13037,10488
12,AVEYRON,145,MILLAU,15785,13867,13369,7517,5852
12,AVEYRON,176,ONET-LE-CHATEAU,5658,5139,4938,2875,2063
12,AVEYRON,202,RODEZ,14528,12599,12199,5960,6239
12,AVEYRON,300,VILLEFRANCHE-DE-ROUERGUE,8600,7337,7077,3965,3112
13,BOUCHES-DU-RHONE,1,AIX-EN-PROVENCE,72091,61161,59115,25821,33294
13,BOUCHES-DU-RHONE,2,ALLAUCH,11637,9971,9399,4796,4603
13,BOUCHES-DU-RHONE,4,ARLES,32334,27608,26323,14714,11609
13,BOUCHES-DU-RHONE,5,AUBAGNE,25911,21441,20359,10440,9919
13,BOUCHES-DU-RHONE,14,BERRE-L'ETANG,6451,5383,5114,3333,1781
13,BOUCHES-DU-RHONE,26,CHATEAUNEUF-LES-MARTIGUES,7506,6472,6159,3659,2500
13,BOUCHES-DU-RHONE,27,CHATEAURENARD,7736,6394,6079,2843,3236
13,BOUCHES-DU-RHONE,28,LA CIOTAT,21924,18593,17666,8969,8697
13,BOUCHES-DU-RHONE,39,FOS-SUR-MER,7068,5992,5678,3374,2304
13,BOUCHES-DU-RHONE,41,GARDANNE,11214,9087,8639,4962,3677
13,BOUCHES-DU-RHONE,47,ISTRES,19878,16827,16015,9168,6847
13,BOUCHES-DU-RHONE,54,MARIGNANE,20235,16109,15318,7203,8115
13,BOUCHES-DU-RHONE,55,MARSEILLE,482154,377247,362475,180797,181678
13,BOUCHES-DU-RHONE,56,MARTIGUES,26137,21937,20819,12391,8428
13,BOUCHES-DU-RHONE,63,MIRAMAS,13660,11154,10600,6202,4398
13,BOUCHES-DU-RHONE,71,LES PENNES-MIRABEAU,13119,10624,10073,5587,4486
13,BOUCHES-DU-RHONE,77,PORT-DE-BOUC,11093,8602,8129,5744,2385
13,BOUCHES-DU-RHONE,78,PORT-SAINT-LOUIS-DU-RHONE,6080,4827,4493,3036,1457
13,BOUCHES-DU-RHONE,81,ROGNAC,6592,5473,5190,2780,2410
13,BOUCHES-DU-RHONE,97,SAINT-MARTIN-DE-CRAU,6689,5898,5644,3217,2427
13,BOUCHES-DU-RHONE,103,SALON-DE-PROVENCE,22735,19178,18278,7912,10366
13,BOUCHES-DU-RHONE,106,SEPTEMES-LES-VALLONS,6854,5756,5448,3306,2142
13,BOUCHES-DU-RHONE,108,TARASCON,7841,6619,6301,3182,3119
13,BOUCHES-DU-RHONE,117,VITROLLES,15741,13073,12426,6515,5911
14,CALVADOS,47,BAYEUX,9529,7654,7441,4061,3380
14,CALVADOS,118,CAEN,66213,53035,51523,28587,22936
14,CALVADOS,327,HEROUVILLE-SAINT-CLAIR,12915,10060,9728,7096,2632
14,CALVADOS,366,LISIEUX,15000,12373,11966,6534,5432
14,CALVADOS,437,MONDEVILLE,6532,5415,5276,3959,1317
14,CALVADOS,762,VIRE,9072,7680,7394,4241,3153
15,CANTAL,14,AURILLAC,18996,16580,16109,8856,7253
16,CHARENTE,15,ANGOULEME,28079,22626,21892,12259,9633
16,CHARENTE,102,COGNAC,12998,10532,10206,5457,4749
16,CHARENTE,374,SOYAUX,6355,5288,5109,3222,1887
17,CHARENTE-MARITIME,299,ROCHEFORT,16578,12798,12356,6502,5854
17,CHARENTE-MARITIME,300,LA ROCHELLE,44091,36002,34998,20069,14929
17,CHARENTE-MARITIME,306,ROYAN,13682,11033,10717,4711,6006
17,CHARENTE-MARITIME,415,SAINTES,18104,14557,14017,8250,5767
18,CHER,33,BOURGES,46921,38201,36508,20167,16341
18,CHER,197,SAINT-AMAND-MONTROND,8574,7147,6897,3884,3013
18,CHER,279,VIERZON,21696,17478,16762,10818,5944
19,CORREZE,31,BRIVE-LA-GAILLARDE,33115,29277,28318,14397,13921
19,CORREZE,272,TULLE,11868,10471,10078,5362,4716
19,CORREZE,275,USSEL,7316,6737,6308,2582,3726
2A,CORSE-DU-SUD (> 1975),4,AJACCIO,26590,21037,20322,8501,11821
2B,HAUTE-CORSE (> 1975),33,BASTIA,20598,14904,14363,8171,6192
21,COTE-D'OR,54,BEAUNE,12028,10150,9846,4677,5169
21,COTE-D'OR,166,CHENOVE,10148,7813,7502,5027,2475
21,COTE-D'OR,231,DIJON,75491,63387,61321,31036,30285
21,COTE-D'OR,617,TALANT,7336,6368,6143,3051,3092
22,COTES-D'ARMOR,50,DINAN,7840,6578,6367,3151,3216
22,COTES-D'ARMOR,93,LAMBALLE,7038,6308,6153,3470,2683
22,COTES-D'ARMOR,113,LANNION,11539,9858,9527,5802,3725
22,COTES-D'ARMOR,136,LOUDEAC,6773,6015,5887,3443,2444
22,COTES-D'ARMOR,187,PLERIN,8817,7571,7303,4436,2867
22,COTES-D'ARMOR,215,PLOUFRAGAN,7165,6297,6082,3975,2107
22,COTES-D'ARMOR,278,SAINT-BRIEUC,32591,27322,26479,15625,10854
23,CREUSE,96,GUERET,9690,8162,7837,4467,3370
24,DORDOGNE,37,BERGERAC,19470,16801,16173,8433,7740
24,DORDOGNE,322,PERIGUEUX,21346,17882,17266,8808,8458
24,DORDOGNE,520,SARLAT-LA-CANEDA,7010,6089,5949,3341,2608
25,DOUBS,31,AUDINCOURT,8960,6874,6600,4197,2403
25,DOUBS,56,BESANCON,59559,50678,48934,26625,22309
25,DOUBS,57,BETHONCOURT,3400,2724,2638,1793,845
25,DOUBS,388,MONTBELIARD,15591,13103,12601,7023,5578
25,DOUBS,462,PONTARLIER,11195,9294,8939,4981,3958
25,DOUBS,580,VALENTIGNEY,7626,6071,5840,3655,2185
26,DROME,58,BOURG-LES-VALENCE,11164,9632,9222,5134,4088
26,DROME,198,MONTELIMAR,17525,15470,14920,7574,7346
26,DROME,235,PIERRELATTE,7410,6172,5886,2841,3045
26,DROME,281,ROMANS-SUR-ISERE,19828,15775,15184,7983,7201
26,DROME,362,VALENCE,38067,31182,30029,14973,15056
27,EURE,56,BERNAY,6966,5726,5541,3104,2437
27,EURE,229,EVREUX,27778,21567,20738,11754,8984
27,EURE,375,LOUVIERS,10960,8793,8470,5017,3453
27,EURE,467,PONT-AUDEMER,5544,4741,4611,2880,1731
27,EURE,681,VERNON,13596,11112,10672,5533,5139
28,EURE-ET-LOIR,85,CHARTRES,21919,18294,17644,9356,8288
28,EURE-ET-LOIR,88,CHATEAUDUN,9122,7680,7410,4233,3177
28,EURE-ET-LOIR,134,DREUX,15773,12319,11800,6624,5176
28,EURE-ET-LOIR,218,LUCE,11784,8925,8572,5379,3193
28,EURE-ET-LOIR,229,MAINVILLIERS,6141,4922,4719,2964,1755
28,EURE-ET-LOIR,280,NOGENT-LE-ROTROU,8359,7258,7013,3981,3032
28,EURE-ET-LOIR,404,VERNOUILLET,5927,4880,4646,2706,1940
29,FINISTERE,19,BREST,94457,77496,75673,43069,32604
29,FINISTERE,39,CONCARNEAU,14565,11910,11620,6853,4767
29,FINISTERE,46,DOUARNENEZ,13419,10980,10694,5832,4862
29,FINISTERE,75,GUIPAVAS,7822,6993,6821,3585,3236
29,FINISTERE,103,LANDERNEAU,9842,8481,8296,4714,3582
29,FINISTERE,151,MORLAIX,11562,9598,9370,5658,3712
29,FINISTERE,189,PLOUGASTEL-DAOULAS,7941,6793,6632,3212,3420
29,FINISTERE,232,QUIMPER,37811,32925,32068,19126,12942
29,FINISTERE,233,QUIMPERLE,7795,6640,6474,3916,2558
29,FINISTERE,235,LE RELECQ-KERHUON,7808,6445,6301,3815,2486
30,GARD,7,ALES,28583,23645,22326,12299,10027
30,GARD,28,BAGNOLS-SUR-CEZE,12217,9749,9330,5076,4254
30,GARD,32,BEAUCAIRE,8205,6791,6380,3353,3027
30,GARD,189,NIMES,79032,65234,62684,31933,30751
30,GARD,258,SAINT-GILLES,6852,5618,5320,2644,2676
30,GARD,341,VAUVERT,5949,5182,4939,2777,2162
30,GARD,351,VILLENEUVE-LES-AVIGNON,6964,6115,5915,2595,3320
31,HAUTE-GARONNE,69,BLAGNAC,10656,9322,8984,5692,3292
31,HAUTE-GARONNE,149,COLOMIERS,16048,13840,13286,8939,4347
31,HAUTE-GARONNE,157,CUGNAUX,6761,5926,5703,3507,2196
31,HAUTE-GARONNE,395,MURET,10370,8835,8489,4620,3869
31,HAUTE-GARONNE,446,RAMONVILLE-SAINT-AGNE,7369,6474,6249,3512,2737
31,HAUTE-GARONNE,483,SAINT-GAUDENS,8794,6836,6594,3277,3317
31,HAUTE-GARONNE,555,TOULOUSE,204875,159698,154613,87537,67076
31,HAUTE-GARONNE,561,L'UNION,8322,7400,7153,4030,3123
32,GERS,13,AUCH,14717,12532,12060,6933,5127
33,GIRONDE,9,ARCACHON,10275,8704,8514,3091,5423
33,GIRONDE,39,BEGLES,16205,12494,11954,8549,3405
33,GIRONDE,56,BLANQUEFORT,6965,5995,5794,3628,2166
33,GIRONDE,63,BORDEAUX,119339,95135,92471,44941,47530
33,GIRONDE,69,LE BOUSCAT,14378,12375,12040,6000,6040
33,GIRONDE,119,CENON,12389,10073,9690,7017,2673
33,GIRONDE,122,CESTAS,9828,8903,8589,5384,3205
33,GIRONDE,162,EYSINES,9680,8338,8047,4528,3519
33,GIRONDE,167,FLOIRAC,8981,7071,6779,4971,1808
33,GIRONDE,192,GRADIGNAN,13292,11202,10869,5906,4963
33,GIRONDE,243,LIBOURNE,14554,12304,11891,6356,5535
33,GIRONDE,249,LORMONT,9872,8363,8032,5756,2276
33,GIRONDE,281,MERIGNAC,35271,29587,28636,16742,11894
33,GIRONDE,318,PESSAC,31083,25689,24851,14322,10529
33,GIRONDE,449,SAINT-MEDARD-EN-JALLES,14182,12498,12035,6856,5179
33,GIRONDE,522,TALENCE,20328,16988,16492,9030,7462
33,GIRONDE,529,LA TESTE-DE-BUCH,13556,11568,11210,5340,5870
33,GIRONDE,550,VILLENAVE-D'ORNON,15149,12998,12534,8063,4471
34,HERAULT,3,AGDE,12538,10602,10252,4791,5461
34,HERAULT,32,BEZIERS,51230,40983,39487,19913,19574
34,HERAULT,57,CASTELNAU-LE-LEZ,8133,7032,6827,2932,3895
34,HERAULT,108,FRONTIGNAN,10938,9253,8877,5320,3557
34,HERAULT,145,LUNEL,10587,9044,8623,4353,4270
34,HERAULT,154,MAUGUIO,8052,7060,6787,3378,3409
34,HERAULT,172,MONTPELLIER,109636,89797,86941,43499,43442
34,HERAULT,301,SETE,28754,23883,22942,11983,10959
35,ILLE-ET-VILAINE,51,CESSON-SEVIGNE,8334,7312,7077,3729,3348
35,ILLE-ET-VILAINE,93,DINARD,7304,6092,5910,2649,3261
35,ILLE-ET-VILAINE,115,FOUGERES,16941,14338,13902,7730,6172
35,ILLE-ET-VILAINE,236,REDON,6255,5350,5194,3006,2188
35,ILLE-ET-VILAINE,238,RENNES,112683,91659,89052,53357,35695
35,ILLE-ET-VILAINE,288,SAINT-MALO,34443,28363,27467,14166,13301
35,ILLE-ET-VILAINE,360,VITRE,9496,8238,7931,3864,4067
36,INDRE,44,CHATEAUROUX,33504,28227,26893,15980,10913
36,INDRE,88,ISSOUDUN,10229,8990,8626,5478,3148
37,INDRE-ET-LOIRE,3,AMBOISE,7156,6027,5823,3100,2723
37,INDRE-ET-LOIRE,122,JOUE-LES-TOURS,21327,17590,16916,9698,7218
37,INDRE-ET-LOIRE,208,SAINT-AVERTIN,7753,6749,6479,3230,3249
37,INDRE-ET-LOIRE,214,SAINT-CYR-SUR-LOIRE,10513,8842,8565,4083,4482
37,INDRE-ET-LOIRE,233,SAINT-PIERRE-DES-CORPS,11362,9003,8540,6550,1990
37,INDRE-ET-LOIRE,261,TOURS,77992,62040,60045,31998,28047
38,ISERE,53,BOURGOIN-JALLIEU,13086,10464,10067,5294,4773
38,ISERE,151,ECHIROLLES,19195,16305,15642,10421,5221
38,ISERE,169,FONTAINE,12871,10284,9902,7151,2751
38,ISERE,185,GRENOBLE,80623,68741,66891,36742,30149
38,ISERE,229,MEYLAN,10363,9178,8923,4113,4810
38,ISERE,317,LE PONT-DE-CLAIX,6051,4869,4692,2892,1800
38,ISERE,382,SAINT-EGREVE,9531,8208,7927,4427,3500
38,ISERE,421,SAINT-MARTIN-D'HERES,15751,12936,12442,8618,3824
38,ISERE,485,SEYSSINET-PARISET,7321,6179,5980,3679,2301
38,ISERE,544,VIENNE,17490,14431,13859,7250,6609
38,ISERE,553,VILLEFONTAINE,5741,4690,4508,2971,1537
38,ISERE,563,VOIRON,10845,9264,8894,4877,4017
39,JURA,97,CHAMPAGNOLE,5816,5130,4931,2884,2047
39,JURA,198,DOLE,15728,13199,12631,7421,5210
39,JURA,300,LONS-LE-SAUNIER,12356,10316,9915,5159,4756
39,JURA,478,SAINT-CLAUDE,6762,5630,5431,3047,2384
40,LANDES,88,DAX,13248,10838,10510,5140,5370
40,LANDES,192,MONT-DE-MARSAN,18560,15640,15134,7739,7395
40,LANDES,279,SAINT-PAUL-LES-DAX,7087,6213,5979,3652,2327
41,LOIR-ET-CHER,18,BLOIS,27228,22655,21829,12190,9639
41,LOIR-ET-CHER,194,ROMORANTIN-LANTHENAY,11371,10029,9605,5423,4182
41,LOIR-ET-CHER,269,VENDOME,11264,9557,9123,5263,3860
42,LOIRE,44,LE CHAMBON-FEUGEROLLES,9637,7597,7191,4310,2881
42,LOIRE,95,FIRMINY,14691,11438,10927,6602,4325
42,LOIRE,147,MONTBRISON,8673,7394,7108,3473,3635
42,LOIRE,183,LA RICAMARIE,6196,4724,4461,2872,1589
42,LOIRE,186,RIVE-DE-GIER,8047,6748,6452,4143,2309
42,LOIRE,187,ROANNE,27122,22013,21182,12097,9085
42,LOIRE,189,ROCHE-LA-MOLIERE,5925,4851,4661,2545,2116
42,LOIRE,207,SAINT-CHAMOND,23538,19752,18842,9913,8929
42,LOIRE,218,SAINT-ETIENNE,119610,92911,89415,46566,42849
42,LOIRE,279,SAINT-JUST-SAINT-RAMBERT,7259,6015,5725,2661,3064
43,HAUTE-LOIRE,157,LE PUY-EN-VELAY,12215,10396,10007,4970,5037
44,LOIRE-ATLANTIQUE,20,BOUGUENAIS,9398,7912,7635,5351,2284
44,LOIRE-ATLANTIQUE,26,CARQUEFOU,7623,6598,6376,3232,3144
44,LOIRE-ATLANTIQUE,35,LA CHAPELLE-SUR-ERDRE,9189,7961,7685,4570,3115
44,LOIRE-ATLANTIQUE,36,CHATEAUBRIANT,9461,8061,7787,4491,3296
44,LOIRE-ATLANTIQUE,47,COUERON,10678,8999,8672,6240,2432
44,LOIRE-ATLANTIQUE,55,LA BAULE-ESCOUBLAC,11929,10133,9850,4017,5833
44,LOIRE-ATLANTIQUE,69,GUERANDE,7253,6212,6010,2881,3129
44,LOIRE-ATLANTIQUE,109,NANTES,155186,123131,119667,64018,55649
44,LOIRE-ATLANTIQUE,114,ORVAULT,16055,13648,13191,7311,5880
44,LOIRE-ATLANTIQUE,143,REZE,23984,19386,18756,12388,6368
44,LOIRE-ATLANTIQUE,162,SAINT-HERBLAIN,28505,23420,22669,14257,8412
44,LOIRE-ATLANTIQUE,184,SAINT-NAZAIRE,44710,35756,34471,22671,11800
44,LOIRE-ATLANTIQUE,190,SAINT-SEBASTIEN-SUR-LOIRE,14384,12533,12141,7378,4763
44,LOIRE-ATLANTIQUE,215,VERTOU,11708,10260,9901,5522,4379
45,LOIRET,4,AMILLY,7405,6376,6050,3196,2854
45,LOIRET,68,CHALETTE-SUR-LOING,7498,6134,5846,3791,2055
45,LOIRET,147,FLEURY-LES-AUBRAIS,12445,10411,9904,6343,3561
45,LOIRET,155,GIEN,8934,7471,7157,3824,3333
45,LOIRET,208,MONTARGIS,9227,7640,7360,3575,3785
45,LOIRET,232,OLIVET,10679,9422,9075,4125,4950
45,LOIRET,234,ORLEANS,56441,46884,45227,22480,22747
45,LOIRET,252,PITHIVIERS,5183,4283,4113,2132,1981
45,LOIRET,284,SAINT-JEAN-DE-BRAYE,9896,8170,7838,4399,3439
45,LOIRET,285,SAINT-JEAN-DE-LA-RUELLE,9223,7867,7531,4336,3195
45,LOIRET,302,SARAN,7814,6814,6500,3922,2578
46,LOT,42,CAHORS,12106,10533,10188,5945,4243
46,LOT,102,FIGEAC,6820,5857,5653,3412,2241
47,LOT-ET-GARONNE,1,AGEN,20963,16793,16190,8350,7840
47,LOT-ET-GARONNE,157,MARMANDE,13126,11162,10746,5838,4908
47,LOT-ET-GARONNE,310,TONNEINS,6686,6069,5822,3439,2383
47,LOT-ET-GARONNE,323,VILLENEUVE-SUR-LOT,16950,14110,13577,6645,6932
48,LOZERE,95,MENDE,6539,5734,5536,2598,2938
49,MAINE-ET-LOIRE,7,ANGERS,79906,65828,63703,33419,30284
49,MAINE-ET-LOIRE,15,AVRILLE,8310,7148,6887,3450,3437
49,MAINE-ET-LOIRE,99,CHOLET,34263,28502,27314,14796,12518
49,MAINE-ET-LOIRE,246,LES PONTS-DE-CE,7404,6459,6197,3516,2681
49,MAINE-ET-LOIRE,267,SAINT-BARTHELEMY-D'ANJOU,6391,5477,5266,3367,1899
49,MAINE-ET-LOIRE,328,SAUMUR,19135,15594,15105,7362,7743
49,MAINE-ET-LOIRE,353,TRELAZE,6862,5558,5357,4034,1323
50,MANCHE,25,AVRANCHES,6206,5146,4967,2491,2476
50,MANCHE,129,CHERBOURG-OCTEVILLE,16863,13340,12924,6899,6025
50,MANCHE,147,COUTANCES,6252,5227,5105,2557,2548
50,MANCHE,173,EQUEURDREVILLE-HAINNEVILLE,11335,9490,9151,6067,3084
50,MANCHE,218,GRANVILLE,9027,7403,7178,3859,3319
50,MANCHE,383,OCTEVILLE,9714,7869,7595,4910,2685
50,MANCHE,502,SAINT-LO,14078,11629,11351,6386,4965
50,MANCHE,602,TOURLAVILLE,10384,8784,8504,5477,3027
51,MARNE,108,CHALONS-EN-CHAMPAGNE,27937,22315,21380,11860,9520
51,MARNE,230,EPERNAY,16970,13601,13145,7782,5363
51,MARNE,454,REIMS,95947,77029,74709,43213,31496
51,MARNE,649,VITRY-LE-FRANCOIS,9656,7659,7424,4403,3021
52,HAUTE-MARNE,121,CHAUMONT,17827,14192,13633,7669,5964
52,HAUTE-MARNE,269,LANGRES,5933,4946,4787,2515,2272
52,HAUTE-MARNE,448,SAINT-DIZIER,20127,15261,14641,8553,6088
53,MAYENNE,130,LAVAL,31535,27619,26598,15455,11143
53,MAYENNE,147,MAYENNE,8869,7633,7365,4363,3002
54,MEURTHE-ET-MOSELLE,159,DOMBASLE-SUR-MEURTHE,6797,5666,5433,3634,1799
54,MEURTHE-ET-MOSELLE,274,JARVILLE-LA-MALGRANGE,6273,4873,4658,2680,1978
54,MEURTHE-ET-MOSELLE,280,JOEUF,5464,4616,4419,3107,1312
54,MEURTHE-ET-MOSELLE,304,LAXOU,9380,7227,6948,3672,3276
54,MEURTHE-ET-MOSELLE,323,LONGWY,9914,7662,7407,4491,2916
54,MEURTHE-ET-MOSELLE,329,LUNEVILLE,13753,11103,10645,6206,4439
54,MEURTHE-ET-MOSELLE,382,MONT-SAINT-MARTIN,4048,3139,3008,1968,1040
54,MEURTHE-ET-MOSELLE,395,NANCY,56229,43070,41682,19703,21979
54,MEURTHE-ET-MOSELLE,431,PONT-A-MOUSSON,8962,7162,6872,3776,3096
54,MEURTHE-ET-MOSELLE,482,SAINT-MAX,7382,6114,5903,2995,2908
54,MEURTHE-ET-MOSELLE,528,TOUL,9516,7684,7300,3883,3417
54,MEURTHE-ET-MOSELLE,547,VANDOEUVRE-LES-NANCY,18560,13910,13436,7787,5649
54,MEURTHE-ET-MOSELLE,578,VILLERS-LES-NANCY,10809,9256,8917,4473,4444
54,MEURTHE-ET-MOSELLE,580,VILLERUPT,6752,5546,5329,4154,1175
55,MEUSE,29,BAR-LE-DUC,11392,9666,9310,5447,3863
55,MEUSE,545,VERDUN,12325,10337,10012,5241,4771
56,MORBIHAN,7,AURAY,6534,5571,5395,2786,2609
56,MORBIHAN,83,HENNEBONT,10054,8552,8293,5440,2853
56,MORBIHAN,98,LANESTER,15299,12712,12183,8278,3905
56,MORBIHAN,121,LORIENT,42802,34407,33150,18629,14521
56,MORBIHAN,162,PLOEMEUR,10507,9090,8721,4610,4111
56,MORBIHAN,178,PONTIVY,8830,7771,7568,4371,3197
56,MORBIHAN,260,VANNES,27161,22266,21623,10499,11124
57,MOSELLE,58,BEHREN-LES-FORBACH,4735,3682,3516,2446,1070
57,MOSELLE,160,CREUTZWALD,8600,6821,6545,4096,2449
57,MOSELLE,206,FAMECK,7683,6310,6034,3978,2056
57,MOSELLE,221,FLORANGE,7175,5995,5726,3515,2211
57,MOSELLE,227,FORBACH,13019,10177,9734,5088,4646
57,MOSELLE,240,FREYMING-MERLEBACH,10567,8563,8151,5162,2989
57,MOSELLE,283,HAGONDANGE,5438,4675,4468,2876,1592
57,MOSELLE,306,HAYANGE,10411,8571,8234,5578,2656
57,MOSELLE,332,HOMBOURG-HAUT,6277,4967,4691,2928,1763
57,MOSELLE,433,MAIZIERES-LES-METZ,5782,5038,4818,3251,1567
57,MOSELLE,447,MARLY,6933,5952,5743,2725,3018
57,MOSELLE,463,METZ,68732,55421,53292,28174,25118
57,MOSELLE,480,MONTIGNY-LES-METZ,15757,13174,12579,6687,5892
57,MOSELLE,491,MOYEUVRE-GRANDE,6126,5012,4795,3702,1093
57,MOSELLE,591,ROMBAS,6126,5139,4908,3242,1666
57,MOSELLE,606,SAINT-AVOLD,11227,9175,8802,4863,3939
57,MOSELLE,630,SARREBOURG,8902,7054,6704,2845,3859
57,MOSELLE,631,SARREGUEMINES,15890,12838,12223,6414,5809
57,MOSELLE,660,STIRING-WENDEL,8568,6547,6226,4015,2211
57,MOSELLE,672,THIONVILLE,25919,21741,21000,11206,9794
57,MOSELLE,683,UCKANGE,4513,3779,3617,2453,1164
57,MOSELLE,751,WOIPPY,6711,5483,5249,3467,1782
57,MOSELLE,757,YUTZ,10265,8437,8079,4742,3337
58,NIEVRE,86,COSNE-COURS-SUR-LOIRE,8859,7493,7224,4271,2953
58,NIEVRE,194,NEVERS,27920,23034,22242,13945,8297
58,NIEVRE,303,VARENNES-VAUZELLES,7191,6273,6000,4294,1706
59,NORD,8,ANICHE,6458,5330,5113,3702,1411
59,NORD,9,VILLENEUVE-D'ASCQ,36463,30118,28974,17577,11397
59,NORD,14,ANZIN,8859,7367,7116,5227,1889
59,NORD,17,ARMENTIERES,16558,14194,13581,8884,4697
59,NORD,33,AULNOYE-AYMERIES,6943,5943,5698,4175,1523
59,NORD,43,BAILLEUL,8871,7959,7663,4422,3241
59,NORD,112,BRUAY-SUR-L'ESCAUT,7794,6571,6263,4572,1691
59,NORD,122,CAMBRAI,23393,19808,19075,10288,8787
59,NORD,131,CAPPELLE-LA-GRANDE,6176,5246,5017,3747,1270
59,NORD,139,CAUDRY,9584,8231,7881,5242,2639
59,NORD,152,COMINES,7359,6096,5818,3561,2257
59,NORD,153,CONDE-SUR-L'ESCAUT,7000,5834,5609,3772,1837
59,NORD,155,COUDEKERQUE-BRANCHE,16426,14100,13421,9172,4249
59,NORD,163,CROIX,13419,11359,10922,5457,5465
59,NORD,172,DENAIN,12692,9886,9549,6957,2592
59,NORD,178,DOUAI,26147,20675,19911,10741,9170
59,NORD,179,DOUCHY-LES-MINES,6601,5358,5082,3769,1313
59,NORD,183,DUNKERQUE,48315,39227,37589,20693,16896
59,NORD,205,ESCAUDAIN,6006,4964,4797,3804,993
59,NORD,220,FACHES-THUMESNIL,12432,10396,9945,5820,4125
59,NORD,249,FOURMIES,9727,8293,7900,5174,2726
59,NORD,271,GRANDE-SYNTHE,13355,11071,10587,7935,2652
59,NORD,273,GRAVELINES,7896,6835,6540,4624,1916
59,NORD,279,HALLUIN,10992,9549,9088,5315,3773
59,NORD,286,HAUBOURDIN,9061,7449,7159,4720,2439
59,NORD,291,HAUTMONT,9926,8059,7627,4826,2801
59,NORD,295,HAZEBROUCK,14053,12396,11907,7576,4331
59,NORD,299,HEM,11870,10221,9846,5434,4412
59,NORD,324,JEUMONT,6560,4859,4681,2845,1836
59,NORD,328,LAMBERSART,20207,16799,16172,7249,8923
59,NORD,350,LILLE,92648,71196,68719,39418,29301
59,NORD,355,LOMME,18378,15211,14605,10086,4519
59,NORD,360,LOOS,12032,10097,9671,6493,3178
59,NORD,367,LYS-LEZ-LANNOY,8207,6993,6686,4010,2676
59,NORD,368,LA MADELEINE,13850,10934,10532,5228,5304
59,NORD,378,MARCQ-EN-BAROEUL,25355,21966,20350,8089,12261
59,NORD,383,MARLY,7993,6640,6346,4340,2006
59,NORD,392,MAUBEUGE,21179,16715,15945,9562,6383
59,NORD,400,MERVILLE,6276,5573,5334,3425,1909
59,NORD,410,MONS-EN-BAROEUL,14537,11559,11105,6615,4490
59,NORD,421,MOUVAUX,9468,8259,8032,3007,5025
59,NORD,426,NEUVILLE-EN-FERRAIN,7198,6286,6029,2971,3058
59,NORD,447,ONNAING,6354,5199,5000,3516,1484
59,NORD,491,RAISMES,9722,8338,8035,5986,2049
59,NORD,507,RONCHIN,12145,9759,9406,5763,3643
59,NORD,508,RONCQ,8002,7163,6895,3671,3224
59,NORD,512,ROUBAIX,44262,35773,34358,19869,14489
59,NORD,526,SAINT-AMAND-LES-EAUX,11597,9654,9188,5772,3416
59,NORD,527,SAINT-ANDRE-LEZ-LILLE,7023,6033,5812,3078,2734
59,NORD,540,SAINT-POL-SUR-MER,15321,12891,12301,9252,3049
59,NORD,544,SAINT-SAULVE,7138,6135,5931,3405,2526
59,NORD,560,SECLIN,8113,6693,6392,4034,2358
59,NORD,569,SIN-LE-NOBLE,11438,9017,8652,5957,2695
59,NORD,574,SOMAIN,8708,7143,6820,5081,1739
59,NORD,599,TOURCOING,53107,44433,42486,23634,18852
59,NORD,606,VALENCIENNES,25626,20471,19732,10324,9408
59,NORD,616,VIEUX-CONDE,7483,6099,5807,3890,1917
59,NORD,646,WASQUEHAL,12592,10562,10129,5513,4616
59,NORD,648,WATTIGNIES,8741,7144,6889,3951,2938
59,NORD,650,WATTRELOS,29080,23623,22535,15231,7304
59,NORD,654,WAZIERS,5300,4293,4133,3167,966
60,OISE,57,BEAUVAIS,30121,26107,25064,14919,10145
60,OISE,141,CHANTILLY,7175,5812,5639,2437,3202
60,OISE,159,COMPIEGNE,21637,18354,17754,8688,9066
60,OISE,175,CREIL,16777,12396,11918,7913,4005
60,OISE,176,CREPY-EN-VALOIS,8174,6968,6696,4290,2406
60,OISE,282,GOUVIEUX,6078,5228,5065,2107,2958
60,OISE,395,MERU,6175,5108,4851,3011,1840
60,OISE,414,MONTATAIRE,6774,5472,5230,3856,1374
60,OISE,463,NOGENT-SUR-OISE,10196,8508,8127,5055,3072
60,OISE,471,NOYON,7604,6094,5870,3173,2697
60,OISE,509,PONT-SAINTE-MAXENCE,5681,4850,4675,2916,1759
60,OISE,612,SENLIS,8865,7253,7005,3124,3881
61,ORNE,1,ALENCON,18618,15207,14657,8343,6314
61,ORNE,6,ARGENTAN,10813,9129,8814,5576,3238
61,ORNE,169,FLERS,10800,9211,8929,5292,3637
61,ORNE,214,L'AIGLE,5712,4822,4675,2539,2136
62,PAS-DE-CALAIS,14,AIRE-SUR-LA-LYS,6728,6004,5770,3627,2143
62,PAS-DE-CALAIS,40,ARQUES,6328,5686,5493,3759,1734
62,PAS-DE-CALAIS,41,ARRAS,25975,22760,21924,12899,9025
62,PAS-DE-CALAIS,48,AUCHEL,8729,7250,6868,4823,2045
62,PAS-DE-CALAIS,65,AVION,12175,10164,9630,7753,1877
62,PAS-DE-CALAIS,108,BERCK,9932,8208,7934,4424,3510
62,PAS-DE-CALAIS,119,BETHUNE,17290,14352,13796,8371,5425
62,PAS-DE-CALAIS,160,BOULOGNE-SUR-MER,29197,23099,22272,13844,8428
62,PAS-DE-CALAIS,178,BRUAY-LA-BUISSIERE,19278,15695,14997,11093,3904
62,PAS-DE-CALAIS,186,BULLY-LES-MINES,8896,7628,7290,5553,1737
62,PAS-DE-CALAIS,193,CALAIS,49977,40054,38328,25112,13216
62,PAS-DE-CALAIS,215,CARVIN,10643,8896,8471,5810,2661
62,PAS-DE-CALAIS,250,COURRIERES,8104,6697,6354,4468,1886
62,PAS-DE-CALAIS,318,ETAPLES,7529,6413,6172,3764,2408
62,PAS-DE-CALAIS,413,HARNES,9090,7454,6997,4855,2142
62,PAS-DE-CALAIS,427,HENIN-BEAUMONT,18023,15054,14381,10001,4380
62,PAS-DE-CALAIS,498,LENS,24703,20589,19742,14112,5630
62,PAS-DE-CALAIS,510,LIEVIN,22200,18346,17485,13859,3626
62,PAS-DE-CALAIS,516,LILLERS,6876,6037,5746,3945,1801
62,PAS-DE-CALAIS,525,LONGUENESSE,7733,6570,6321,4287,2034
62,PAS-DE-CALAIS,570,MERICOURT,8653,7160,6825,5189,1636
62,PAS-DE-CALAIS,587,MONTIGNY-EN-GOHELLE,6531,5240,4902,3665,1237
62,PAS-DE-CALAIS,617,NOEUX-LES-MINES,9095,7693,7368,5246,2122
62,PAS-DE-CALAIS,637,OIGNIES,6554,5575,5296,3512,1784
62,PAS-DE-CALAIS,643,OUTREAU,9940,8534,8133,6222,1911
62,PAS-DE-CALAIS,667,LE PORTEL,7225,5776,5562,3308,2254
62,PAS-DE-CALAIS,724,ROUVROY,6055,5238,4924,3747,1177
62,PAS-DE-CALAIS,758,SAINT-MARTIN-BOULOGNE,8172,6842,6570,4017,2553
62,PAS-DE-CALAIS,765,SAINT-OMER,9945,8315,8034,4408,3626
62,PAS-DE-CALAIS,771,SALLAUMINES,7381,5866,5633,4390,1243
62,PAS-DE-CALAIS,907,LIBERCOURT,5567,4537,4318,2943,1375
63,PUY-DE-DOME,75,CHAMALIERES,11741,10035,9703,3368,6335
63,PUY-DE-DOME,113,CLERMONT-FERRAND,71629,59099,56995,32097,24898
63,PUY-DE-DOME,124,COURNON-D'AUVERGNE,11495,9855,9385,5549,3836
63,PUY-DE-DOME,178,ISSOIRE,8518,7293,7011,3694,3317
63,PUY-DE-DOME,300,RIOM,10497,9205,8811,4857,3954
63,PUY-DE-DOME,430,THIERS,9951,8338,7921,4535,3386
64,PYRENEES-ATLANTIQUES,24,ANGLET,22755,19372,18744,9045,9699
64,PYRENEES-ATLANTIQUES,102,BAYONNE,25729,20650,20034,10220,9814
64,PYRENEES-ATLANTIQUES,122,BIARRITZ,20990,17226,16728,7115,9613
64,PYRENEES-ATLANTIQUES,129,BILLERE,8490,6920,6700,3498,3202
64,PYRENEES-ATLANTIQUES,260,HENDAYE,7276,5993,5815,3420,2395
64,PYRENEES-ATLANTIQUES,410,MOURENX,5475,4100,3955,2609,1346
64,PYRENEES-ATLANTIQUES,422,OLORON-SAINTE-MARIE,8105,6864,6607,3928,2679
64,PYRENEES-ATLANTIQUES,430,ORTHEZ,7928,6947,6717,3824,2893
64,PYRENEES-ATLANTIQUES,445,PAU,50165,41932,40664,20134,20530
64,PYRENEES-ATLANTIQUES,483,SAINT-JEAN-DE-LUZ,9310,8127,7896,3433,4463
65,HAUTES-PYRENEES,59,BAGNERES-DE-BIGORRE,6257,5226,5042,2911,2131
65,HAUTES-PYRENEES,286,LOURDES,12418,10777,10420,4906,5514
65,HAUTES-PYRENEES,440,TARBES,32047,24688,23838,13795,10043
66,PYRENEES-ORIENTALES,136,PERPIGNAN,70790,55834,53740,25174,28566
67,BAS-RHIN,43,BISCHHEIM,9702,7016,6709,3912,2797
67,BAS-RHIN,46,BISCHWILLER,5254,4316,4088,2032,2056
67,BAS-RHIN,180,HAGUENAU,16659,14127,13573,6128,7445
67,BAS-RHIN,204,HOENHEIM,6810,5567,5331,2733,2598
67,BAS-RHIN,218,ILLKIRCH-GRAFFENSTADEN,14665,11966,11468,5607,5861
67,BAS-RHIN,267,LINGOLSHEIM,11124,9010,8588,4277,4311
67,BAS-RHIN,365,OSTWALD,6724,5462,5207,2802,2405
67,BAS-RHIN,437,SAVERNE,6488,5441,5193,2004,3189
67,BAS-RHIN,447,SCHILTIGHEIM,18058,13602,13092,7386,5706
67,BAS-RHIN,462,SELESTAT,10599,8754,8354,4372,3982
67,BAS-RHIN,482,STRASBOURG,127373,100719,97278,48509,48769
68,HAUT-RHIN,63,CERNAY,6152,5041,4773,2878,1895
68,HAUT-RHIN,66,COLMAR,36054,29124,27794,13644,14150
68,HAUT-RHIN,112,GUEBWILLER,6221,5231,5004,2840,2164
68,HAUT-RHIN,154,ILLZACH,9032,7008,6651,3522,3129
68,HAUT-RHIN,166,KINGERSHEIM,7314,5963,5656,3249,2407
68,HAUT-RHIN,224,MULHOUSE,59069,46302,43962,23174,20788
68,HAUT-RHIN,271,RIEDISHEIM,8806,7150,6837,3034,3803
68,HAUT-RHIN,278,RIXHEIM,7278,6047,5758,2782,2976
68,HAUT-RHIN,297,SAINT-LOUIS,10649,8239,7868,3821,4047
68,HAUT-RHIN,375,WITTELSHEIM,6871,5858,5631,3929,1702
68,HAUT-RHIN,376,WITTENHEIM,8735,7161,6833,4466,2367
69,RHONE,27,BRIGNAIS,5218,4597,4429,2162,2267
69,RHONE,29,BRON,22341,18068,17317,8693,8624
69,RHONE,34,CALUIRE-ET-CUIRE,26748,22833,22095,9400,12695
69,RHONE,81,ECULLY,12224,10132,9846,3367,6479
69,RHONE,89,FRANCHEVILLE,6877,5887,5685,2483,3202
69,RHONE,91,GIVORS,11683,8567,8212,5563,2649
69,RHONE,123,LYON,239522,193136,186813,84109,102704
69,RHONE,149,OULLINS,17253,13746,13229,7486,5743
69,RHONE,152,PIERRE-BENITE,4961,4149,3969,2602,1367
69,RHONE,199,SAINT-FONS,7987,6144,5875,3935,1940
69,RHONE,202,SAINTE-FOY-LES-LYON,13964,12026,11647,4545,7102
69,RHONE,204,SAINT-GENIS-LAVAL,10315,8848,8513,4030,4483
69,RHONE,243,TARARE,7037,5550,5346,2986,2360
69,RHONE,244,TASSIN-LA-DEMI-LUNE,9840,8505,8261,3099,5162
69,RHONE,256,VAULX-EN-VELIN,18241,13123,12524,8335,4189
69,RHONE,259,VENISSIEUX,30931,23278,22091,15096,6995
69,RHONE,264,VILLEFRANCHE-SUR-SAONE,14906,12018,11527,5710,5817
69,RHONE,266,VILLEURBANNE,62766,52561,50492,28264,22228
69,RHONE,275,DECINES-CHARPIEU,12867,10463,10018,5959,4059
69,RHONE,282,MEYZIEU,16326,13669,13078,7235,5843
69,RHONE,286,RILLIEUX-LA-PAPE,16743,12909,12353,6296,6057
69,RHONE,290,SAINT-PRIEST,22492,18237,17341,10054,7287
70,HAUTE-SAONE,285,HERICOURT,5755,4935,4709,3211,1498
70,HAUTE-SAONE,310,LURE,4962,4309,4121,2184,1937
70,HAUTE-SAONE,311,LUXEUIL-LES-BAINS,5454,4595,4382,2339,2043
70,HAUTE-SAONE,550,VESOUL,9101,7878,7579,4124,3455
71,SAONE-ET-LOIRE,14,AUTUN,11708,9878,9499,5231,4268
71,SAONE-ET-LOIRE,76,CHALON-SUR-SAONE,31209,25473,24561,13595,10966
71,SAONE-ET-LOIRE,153,LE CREUSOT,18309,15297,14725,8912,5813
71,SAONE-ET-LOIRE,176,DIGOIN,6127,5046,4914,3161,1753
71,SAONE-ET-LOIRE,230,GUEUGNON,6553,5606,5432,3637,1795
71,SAONE-ET-LOIRE,270,MACON,21126,16344,15745,8671,7074
71,SAONE-ET-LOIRE,306,MONTCEAU-LES-MINES,17330,13507,13065,7498,5567
71,SAONE-ET-LOIRE,342,PARAY-LE-MONIAL,7168,5920,5758,3122,2636
71,SAONE-ET-LOIRE,486,SAINT-VALLIER,7109,5599,5382,3293,2089
72,SARTHE,3,ALLONNES,9119,7027,6760,5008,1752
72,SARTHE,132,LA FERTE-BERNARD,6405,5136,4937,2970,1967
72,SARTHE,154,LA FLECHE,10100,8631,8329,4605,3724
72,SARTHE,181,LE MANS,97094,79369,76462,46530,29932
72,SARTHE,264,SABLE-SUR-SARTHE,7923,6658,6383,3405,2978
73,SAVOIE,8,AIX-LES-BAINS,15620,13027,12535,5392,7143
73,SAVOIE,11,ALBERTVILLE,10174,8056,7790,3838,3952
73,SAVOIE,65,CHAMBERY,28880,24147,23392,11657,11735
73,SAVOIE,248,SAINT-JEAN-DE-MAURIENNE,4968,4091,3954,2102,1852
74,HAUTE-SAVOIE,10,ANNECY,28265,23336,22575,10096,12479
74,HAUTE-SAVOIE,11,ANNECY-LE-VIEUX,10325,8746,8449,3541,4908
74,HAUTE-SAVOIE,12,ANNEMASSE,13110,10613,10277,4893,5384
74,HAUTE-SAVOIE,81,CLUSES,7851,6400,6168,2979,3189
74,HAUTE-SAVOIE,93,CRAN-GEVRIER,7446,6363,6144,3555,2589
74,HAUTE-SAVOIE,133,GAILLARD,5118,3975,3849,1682,2167
74,HAUTE-SAVOIE,256,SALLANCHES,6617,5509,5342,2130,3212
74,HAUTE-SAVOIE,268,SEYNOD,7045,5933,5694,3020,2674
74,HAUTE-SAVOIE,281,THONON-LES-BAINS,17465,14534,13986,6146,7840
75,PARIS,100,PARIS,1238758,994456,968662,439007,529655
76,SEINE-MARITIME,57,BARENTIN,8153,6857,6630,4850,1780
76,SEINE-MARITIME,95,BIHOREL,6571,5742,5566,2727,2839
76,SEINE-MARITIME,108,BOIS-GUILLAUME,7704,6705,6508,2343,4165
76,SEINE-MARITIME,114,BOLBEC,8383,6911,6678,4486,2192
76,SEINE-MARITIME,157,CANTELEU,8699,7067,6784,4792,1992
76,SEINE-MARITIME,165,CAUDEBEC-LES-ELBEUF,6705,5055,4845,3102,1743
76,SEINE-MARITIME,212,DARNETAL,6110,4717,4541,3115,1426
76,SEINE-MARITIME,216,DEVILLE-LES-ROUEN,7843,6040,5798,3863,1935
76,SEINE-MARITIME,217,DIEPPE,25019,20981,20365,12797,7568
76,SEINE-MARITIME,231,ELBEUF,9100,7022,6751,4324,2427
76,SEINE-MARITIME,259,FECAMP,14216,11661,11297,7259,4038
76,SEINE-MARITIME,305,GONFREVILLE-L'ORCHER,6476,5459,5277,4383,894
76,SEINE-MARITIME,319,GRAND-COURONNE,6273,5122,4900,3449,1451
76,SEINE-MARITIME,322,LE GRAND-QUEVILLY,20003,17428,16774,13111,3663
76,SEINE-MARITIME,341,HARFLEUR,5669,4968,4796,3482,1314
76,SEINE-MARITIME,351,LE HAVRE,125802,99995,96131,59680,36451
76,SEINE-MARITIME,384,LILLEBONNE,6113,5005,4818,3225,1593
76,SEINE-MARITIME,410,MAROMME,8031,6744,6491,4423,2068
76,SEINE-MARITIME,447,MONTIVILLIERS,11146,9173,8854,5572,3282
76,SEINE-MARITIME,451,MONT-SAINT-AIGNAN,12048,10030,9721,4204,5517
76,SEINE-MARITIME,484,OISSEL,7275,5875,5599,3873,1726
76,SEINE-MARITIME,498,LE PETIT-QUEVILLY,13245,10384,9947,7235,2712
76,SEINE-MARITIME,540,ROUEN,58548,48544,46934,25458,21476
76,SEINE-MARITIME,561,SAINT-AUBIN-LES-ELBEUF,5442,4617,4438,2724,1714
76,SEINE-MARITIME,575,SAINT-ETIENNE-DU-ROUVRAY,18611,14646,14052,10532,3520
76,SEINE-MARITIME,681,SOTTEVILLE-LES-ROUEN,20843,17041,16351,11301,5050
76,SEINE-MARITIME,758,YVETOT,7670,6362,6170,3807,2363
77,SEINE-ET-MARNE,14,AVON,8959,7115,6839,3206,3633
77,SEINE-ET-MARNE,53,BRIE-COMTE-ROBERT,6102,5205,4996,2676,2320
77,SEINE-ET-MARNE,83,CHAMPS-SUR-MARNE,9966,8149,7863,4670,3193
77,SEINE-ET-MARNE,108,CHELLES,27204,22068,21137,11630,9507
77,SEINE-ET-MARNE,122,COMBS-LA-VILLE,10330,8962,8618,4818,3800
77,SEINE-ET-MARNE,131,COULOMMIERS,7644,5949,5720,3181,2539
77,SEINE-ET-MARNE,152,DAMMARIE-LES-LYS,10759,8502,8134,4810,3324
77,SEINE-ET-MARNE,186,FONTAINEBLEAU,10419,8625,8363,2989,5374
77,SEINE-ET-MARNE,243,LAGNY-SUR-MARNE,10672,8653,8308,4217,4091
77,SEINE-ET-MARNE,284,MEAUX,22289,17444,16746,9257,7489
77,SEINE-ET-MARNE,285,LE MEE-SUR-SEINE,9975,8079,7720,4557,3163
77,SEINE-ET-MARNE,288,MELUN,18891,14899,14403,7297,7106
77,SEINE-ET-MARNE,294,MITRY-MORY,10044,7701,7343,4651,2692
77,SEINE-ET-MARNE,305,MONTEREAU-FAULT-YONNE,8580,7079,6773,3919,2854
77,SEINE-ET-MARNE,333,NEMOURS,6081,4919,4727,2576,2151
77,SEINE-ET-MARNE,337,NOISIEL,6821,5811,5605,3576,2029
77,SEINE-ET-MARNE,350,OZOIR-LA-FERRIERE,8642,7363,7070,3759,3311
77,SEINE-ET-MARNE,373,PONTAULT-COMBAULT,12125,9999,9653,5197,4456
77,SEINE-ET-MARNE,379,PROVINS,6825,5390,5186,2688,2498
77,SEINE-ET-MARNE,390,ROISSY-EN-BRIE,9588,7827,7486,4655,2831
77,SEINE-ET-MARNE,407,SAINT-FARGEAU-PONTHIERRY,6504,5235,5050,2382,2668
77,SEINE-ET-MARNE,445,SAVIGNY-LE-TEMPLE,7565,6381,6097,4028,2069
77,SEINE-ET-MARNE,468,TORCY,7270,6027,5807,3604,2203
77,SEINE-ET-MARNE,479,VAIRES-SUR-MARNE,7708,6364,6102,3233,2869
77,SEINE-ET-MARNE,514,VILLEPARISIS,10332,8271,7863,4699,3164
78,YVELINES,5,ACHERES,8590,6968,6651,4274,2377
78,YVELINES,15,ANDRESY,7859,6621,6359,3078,3281
78,YVELINES,29,AUBERGENVILLE,6171,4822,4623,2715,1908
78,YVELINES,73,BOIS-D'ARCY,6875,5965,5748,2922,2826
78,YVELINES,123,CARRIERES-SOUS-POISSY,4086,3391,3285,1908,1377
78,YVELINES,124,CARRIERES-SUR-SEINE,6218,5227,5016,2505,2511
78,YVELINES,126,LA CELLE-SAINT-CLOUD,15062,12388,12066,4777,7289
78,YVELINES,138,CHANTELOUP-LES-VIGNES,3437,2616,2513,1479,1034
78,YVELINES,146,CHATOU,19285,15423,14958,5902,9056
78,YVELINES,158,LE CHESNAY,18984,15944,15593,5126,10467
78,YVELINES,165,LES CLAYES-SOUS-BOIS,10409,8834,8454,5015,3439
78,YVELINES,172,CONFLANS-SAINTE-HONORINE,20098,16308,15617,9078,6539
78,YVELINES,208,ELANCOURT,12447,10418,9998,5326,4672
78,YVELINES,242,FONTENAY-LE-FLEURY,8009,6784,6578,3168,3410
78,YVELINES,297,GUYANCOURT,7723,6547,6259,3688,2571
78,YVELINES,311,HOUILLES,17865,15311,14691,8033,6658
78,YVELINES,335,LIMAY,6021,5217,4987,3034,1953
78,YVELINES,358,MAISONS-LAFFITTE,14915,12866,12532,4219,8313
78,YVELINES,361,MANTES-LA-JOLIE,19246,14407,13832,7689,6143
78,YVELINES,362,MANTES-LA-VILLE,11303,9148,8697,5445,3252
78,YVELINES,372,MARLY-LE-ROI,11612,9806,9528,4078,5450
78,YVELINES,383,MAUREPAS,13092,11040,10628,5640,4988
78,YVELINES,418,MONTESSON,7253,6214,5971,2827,3144
78,YVELINES,423,MONTIGNY-LE-BRETONNEUX,12292,10946,10600,5963,4637
78,YVELINES,440,LES MUREAUX,13356,10615,10167,6403,3764
78,YVELINES,481,LE PECQ,11759,9651,9387,3902,5485
78,YVELINES,490,PLAISIR,12874,10423,10060,5473,4587
78,YVELINES,498,POISSY,20424,16970,16338,8785,7553
78,YVELINES,517,RAMBOUILLET,15090,12621,12165,5946,6219
78,YVELINES,545,SAINT-CYR-L'ECOLE,9865,7971,7654,4362,3292
78,YVELINES,551,SAINT-GERMAIN-EN-LAYE,25773,21537,20903,7837,13066
78,YVELINES,586,SARTROUVILLE,26812,21554,20692,11807,8885
78,YVELINES,621,TRAPPES,13231,9797,9294,6588,2706
78,YVELINES,640,VELIZY-VILLACOUBLAY,15108,13025,12547,5974,6573
78,YVELINES,642,VERNEUIL-SUR-SEINE,8052,6734,6480,3499,2981
78,YVELINES,646,VERSAILLES,59760,49972,48581,16296,32285
78,YVELINES,650,LE VESINET,11911,10225,9983,2510,7473
78,YVELINES,686,VIROFLAY,10617,8853,8545,3597,4948
79,DEUX-SEVRES,49,BRESSUIRE,12013,10617,10210,5090,5120
79,DEUX-SEVRES,191,NIORT,38401,31595,30571,17702,12869
79,DEUX-SEVRES,202,PARTHENAY,7715,6798,6514,3669,2845
79,DEUX-SEVRES,329,THOUARS,7796,6609,6394,4124,2270
80,SOMME,1,ABBEVILLE,16818,14487,13952,8993,4959
80,SOMME,16,ALBERT,7660,6570,6349,4090,2259
80,SOMME,21,AMIENS,76061,62736,60322,35389,24933
80,SOMME,620,PERONNE,5431,4759,4612,2839,1773
81,TARN,4,ALBI,31762,27082,26056,14103,11953
81,TARN,60,CARMAUX,8897,7491,7189,5038,2151
81,TARN,65,CASTRES,30431,26353,25277,12680,12597
81,TARN,99,GAILLAC,7772,6761,6497,3383,3114
81,TARN,105,GRAULHET,8839,7924,7576,4245,3331
81,TARN,163,MAZAMET,8708,7759,7494,3450,4044
82,TARN-ET-GARONNE,33,CASTELSARRASIN,8170,7009,6720,3909,2811
82,TARN-ET-GARONNE,112,MOISSAC,8679,7289,6984,3683,3301
82,TARN-ET-GARONNE,121,MONTAUBAN,33241,28852,27849,14916,12933
83,VAR,23,BRIGNOLES,7101,6052,5819,2683,3136
83,VAR,50,DRAGUIGNAN,19129,16496,15918,7574,8344
83,VAR,61,FREJUS,23571,19037,18460,6814,11646
83,VAR,62,LA GARDE,14252,11870,11409,5287,6122
83,VAR,69,HYERES,30557,26193,25308,9952,15356
83,VAR,90,OLLIOULES,6688,5596,5395,2389,3006
83,VAR,118,SAINT-RAPHAEL,19987,17061,16533,5539,10994
83,VAR,123,SANARY-SUR-MER,10786,8765,8480,3003,5477
83,VAR,126,LA SEYNE-SUR-MER,39922,32493,31026,15908,15118
83,VAR,129,SIX-FOURS-LES-PLAGES,20689,17025,16412,6500,9912
83,VAR,137,TOULON,115143,92233,88781,38593,50188
83,VAR,144,LA VALETTE-DU-VAR,13081,10846,10409,4587,5822
84,VAUCLUSE,3,APT,7826,6283,5996,2656,3340
84,VAUCLUSE,7,AVIGNON,53937,45974,43968,22496,21472
84,VAUCLUSE,19,BOLLENE,8896,7348,6990,3986,3004
84,VAUCLUSE,31,CARPENTRAS,16579,13277,12695,5587,7108
84,VAUCLUSE,35,CAVAILLON,14183,11928,11425,5539,5886
84,VAUCLUSE,54,L'ISLE-SUR-LA-SORGUE,9645,7931,7531,3876,3655
84,VAUCLUSE,87,ORANGE,16419,14195,13555,5812,7743
84,VAUCLUSE,89,PERTUIS,9362,8138,7767,4068,3699
84,VAUCLUSE,92,LE PONTET,9298,8088,7704,4048,3656
84,VAUCLUSE,129,SORGUES,10118,8339,7861,4181,3680
85,VENDEE,47,CHALLANS,10125,8664,8360,4133,4227
85,VENDEE,92,FONTENAY-LE-COMTE,9216,8037,7764,4076,3688
85,VENDEE,109,LES HERBIERS,8701,7684,7405,2848,4557
85,VENDEE,128,LUCON,6273,5490,5345,2908,2437
85,VENDEE,191,LA ROCHE-SUR-YON,30215,26015,25130,14606,10524
85,VENDEE,194,LES SABLES-D'OLONNE,13207,10657,10354,4716,5638
86,VIENNE,66,CHATELLERAULT,24606,20177,19371,11225,8146
86,VIENNE,194,POITIERS,45212,37153,35965,20224,15741
87,HAUTE-VIENNE,85,LIMOGES,85195,73205,69988,42346,27642
87,HAUTE-VIENNE,154,SAINT-JUNIEN,8726,7655,7376,4809,2567
88,VOSGES,160,EPINAL,23157,19427,18614,9778,8836
88,VOSGES,196,GERARDMER,6269,5445,5208,2960,2248
88,VOSGES,383,REMIREMONT,6029,5016,4763,2385,2378
88,VOSGES,413,SAINT-DIE,15324,12434,11894,6616,5278
89,YONNE,24,AUXERRE,21995,18315,17572,9344,8228
89,YONNE,206,JOIGNY,6143,4961,4750,2213,2537
89,YONNE,387,SENS,15250,12641,12059,6043,6016
90,TERRITOIRE DE BELFORT,10,BELFORT,28865,23882,22720,12995,9725
91,ESSONNE,27,ATHIS-MONS,16764,13807,13251,7559,5692
91,ESSONNE,103,BRETIGNY-SUR-ORGE,11262,9624,9275,5450,3825
91,ESSONNE,114,BRUNOY,15641,13043,12556,6101,6455
91,ESSONNE,161,CHILLY-MAZARIN,10532,8766,8431,4353,4078
91,ESSONNE,174,CORBEIL-ESSONNES,19821,15749,15020,9051,5969
91,ESSONNE,201,DRAVEIL,16723,13831,13351,7584,5767
91,ESSONNE,215,EPINAY-SOUS-SENART,7047,5415,5214,3146,2068
91,ESSONNE,223,ETAMPES,11295,9343,8923,5105,3818
91,ESSONNE,228,EVRY,17796,14940,14371,8711,5660
91,ESSONNE,272,GIF-SUR-YVETTE,12298,10699,10346,4793,5553
91,ESSONNE,286,GRIGNY,10778,8507,8126,5156,2970
91,ESSONNE,312,IGNY,6395,5577,5377,3014,2363
91,ESSONNE,326,JUVISY-SUR-ORGE,8394,6894,6661,3342,3319
91,ESSONNE,345,LONGJUMEAU,10958,9207,8876,5122,3754
91,ESSONNE,377,MASSY,23585,19002,18292,11380,6912
91,ESSONNE,386,MENNECY,7367,6201,5986,2656,3330
91,ESSONNE,421,MONTGERON,14657,12210,11724,5900,5824
91,ESSONNE,432,MORANGIS,6623,5519,5271,2905,2366
91,ESSONNE,434,MORSANG-SUR-ORGE,12691,10222,9734,5762,3972
91,ESSONNE,471,ORSAY,10449,8699,8387,4464,3923
91,ESSONNE,477,PALAISEAU,19479,16026,15365,8775,6590
91,ESSONNE,521,RIS-ORANGIS,16252,13090,12603,6943,5660
91,ESSONNE,549,SAINTE-GENEVIEVE-DES-BOIS,18114,15179,14577,8296,6281
91,ESSONNE,570,SAINT-MICHEL-SUR-ORGE,13036,10587,10186,5677,4509
91,ESSONNE,589,SAVIGNY-SUR-ORGE,20754,17632,16909,9285,7624
91,ESSONNE,645,VERRIERES-LE-BUISSON,10277,8884,8612,3905,4707
91,ESSONNE,657,VIGNEUX-SUR-SEINE,14971,11754,11257,7075,4182
91,ESSONNE,687,VIRY-CHATILLON,18114,14477,13928,7242,6686
91,ESSONNE,691,YERRES,17941,15002,14406,7931,6475
91,ESSONNE,692,LES ULIS,11630,9887,9476,6248,3228
92,HAUTS-DE-SEINE,2,ANTONY,35338,30751,29658,15879,13779
92,HAUTS-DE-SEINE,4,ASNIERES-SUR-SEINE,39942,32732,31605,14504,17101
92,HAUTS-DE-SEINE,7,BAGNEUX,23156,17389,16617,10864,5753
92,HAUTS-DE-SEINE,9,BOIS-COLOMBES,15575,13028,12583,5307,7276
92,HAUTS-DE-SEINE,12,BOULOGNE-BILLANCOURT,60264,49820,48504,19045,29459
92,HAUTS-DE-SEINE,14,BOURG-LA-REINE,12513,10470,10165,4355,5810
92,HAUTS-DE-SEINE,19,CHATENAY-MALABRY,17271,14030,13593,7420,6173
92,HAUTS-DE-SEINE,20,CHATILLON,15006,12881,12409,6744,5665
92,HAUTS-DE-SEINE,22,CHAVILLE,12120,10204,9852,4784,5068
92,HAUTS-DE-SEINE,23,CLAMART,31191,26329,25464,13369,12095
92,HAUTS-DE-SEINE,24,CLICHY,25275,19684,19012,11113,7899
92,HAUTS-DE-SEINE,25,COLOMBES,44870,37142,35569,19764,15805
92,HAUTS-DE-SEINE,26,COURBEVOIE,34761,29772,28910,12064,16846
92,HAUTS-DE-SEINE,32,FONTENAY-AUX-ROSES,15025,12874,12456,6661,5795
92,HAUTS-DE-SEINE,33,GARCHES,10794,9445,9184,3238,5946
92,HAUTS-DE-SEINE,35,LA GARENNE-COLOMBES,13376,11244,10827,4973,5854
92,HAUTS-DE-SEINE,36,GENNEVILLIERS,19395,15664,14923,10579,4344
92,HAUTS-DE-SEINE,40,ISSY-LES-MOULINEAUX,27197,22638,21889,11651,10238
92,HAUTS-DE-SEINE,44,LEVALLOIS-PERRET,26794,23170,22423,10416,12007
92,HAUTS-DE-SEINE,46,MALAKOFF,20200,15825,15137,9649,5488
92,HAUTS-DE-SEINE,48,MEUDON,31187,25388,24625,12209,12416
92,HAUTS-DE-SEINE,49,MONTROUGE,22671,19039,18430,9659,8771
92,HAUTS-DE-SEINE,50,NANTERRE,39976,32660,31173,19682,11491
92,HAUTS-DE-SEINE,51,NEUILLY-SUR-SEINE,37180,32734,32168,5912,26256
92,HAUTS-DE-SEINE,60,LE PLESSIS-ROBINSON,13105,10848,10390,6005,4385
92,HAUTS-DE-SEINE,62,PUTEAUX,22099,18649,18008,9059,8949
92,HAUTS-DE-SEINE,63,RUEIL-MALMAISON,42118,35801,34616,16015,18601
92,HAUTS-DE-SEINE,64,SAINT-CLOUD,18952,15928,15549,4703,10846
92,HAUTS-DE-SEINE,71,SCEAUX,13242,11619,11315,4538,6777
92,HAUTS-DE-SEINE,72,SEVRES,13518,11836,11499,5488,6011
92,HAUTS-DE-SEINE,73,SURESNES,21065,17693,17094,9019,8075
92,HAUTS-DE-SEINE,75,VANVES,15550,13414,12981,6657,6324
92,HAUTS-DE-SEINE,77,VILLE-D'AVRAY,7349,6368,6215,1854,4361
92,HAUTS-DE-SEINE,78,VILLENEUVE-LA-GARENNE,12120,9537,9150,5742,3408
93,SEINE-SAINT-DENIS,1,AUBERVILLIERS,30791,23243,22217,15148,7069
93,SEINE-SAINT-DENIS,5,AULNAY-SOUS-BOIS,40067,32115,30782,17454,13328
93,SEINE-SAINT-DENIS,6,BAGNOLET,16269,12906,12269,8155,4114
93,SEINE-SAINT-DENIS,7,LE BLANC-MESNIL,25522,20153,19204,12055,7149
93,SEINE-SAINT-DENIS,8,BOBIGNY,20591,15952,15131,10451,4680
93,SEINE-SAINT-DENIS,10,BONDY,25402,20298,19388,12350,7038
93,SEINE-SAINT-DENIS,13,LE BOURGET,6592,5465,5236,2679,2557
93,SEINE-SAINT-DENIS,14,CLICHY-SOUS-BOIS,10622,8193,7731,4486,3245
93,SEINE-SAINT-DENIS,27,LA COURNEUVE,15208,11967,11437,7830,3607
93,SEINE-SAINT-DENIS,29,DRANCY,36882,27975,26624,17396,9228
93,SEINE-SAINT-DENIS,31,EPINAY-SUR-SEINE,25385,20496,19656,12000,7656
93,SEINE-SAINT-DENIS,32,GAGNY,22701,18643,17928,9784,8144
93,SEINE-SAINT-DENIS,45,LES LILAS,11821,10022,9620,5283,4337
93,SEINE-SAINT-DENIS,46,LIVRY-GARGAN,21508,18073,17267,9562,7705
93,SEINE-SAINT-DENIS,47,MONTFERMEIL,11725,9592,9165,4780,4385
93,SEINE-SAINT-DENIS,48,MONTREUIL,50830,38231,36562,23271,13291
93,SEINE-SAINT-DENIS,49,NEUILLY-PLAISANCE,10328,8457,8148,4296,3852
93,SEINE-SAINT-DENIS,50,NEUILLY-SUR-MARNE,16485,13351,12801,8094,4707
93,SEINE-SAINT-DENIS,51,NOISY-LE-GRAND,24442,20405,19588,11081,8507
93,SEINE-SAINT-DENIS,53,NOISY-LE-SEC,20538,16127,15355,9325,6030
93,SEINE-SAINT-DENIS,55,PANTIN,23667,18307,17521,10674,6847
93,SEINE-SAINT-DENIS,57,LES PAVILLONS-SOUS-BOIS,11318,9042,8623,4342,4281
93,SEINE-SAINT-DENIS,59,PIERREFITTE-SUR-SEINE,11647,9555,9123,5885,3238
93,SEINE-SAINT-DENIS,61,LE PRE-SAINT-GERVAIS,7496,6069,5853,3623,2230
93,SEINE-SAINT-DENIS,62,LE RAINCY,9214,7784,7547,2869,4678
93,SEINE-SAINT-DENIS,63,ROMAINVILLE,14298,10301,9739,6427,3312
93,SEINE-SAINT-DENIS,64,ROSNY-SOUS-BOIS,21607,17226,16507,8729,7778
93,SEINE-SAINT-DENIS,66,SAINT-DENIS,39169,29935,28546,19838,8708
93,SEINE-SAINT-DENIS,70,SAINT-OUEN,19536,15342,14625,9481,5144
93,SEINE-SAINT-DENIS,71,SEVRAN,21428,17319,16546,10426,6120
93,SEINE-SAINT-DENIS,72,STAINS,17496,13510,12852,8941,3911
93,SEINE-SAINT-DENIS,73,TREMBLAY-EN-FRANCE,17494,14061,13385,8500,4885
93,SEINE-SAINT-DENIS,77,VILLEMOMBLE,17780,14380,13882,6475,7407
93,SEINE-SAINT-DENIS,78,VILLEPINTE,13350,10651,10193,5832,4361
93,SEINE-SAINT-DENIS,79,VILLETANEUSE,4271,3438,3286,2312,974
94,VAL-DE-MARNE,2,ALFORTVILLE,22475,17251,16615,10987,5628
94,VAL-DE-MARNE,3,ARCUEIL,12656,9756,9240,6303,2937
94,VAL-DE-MARNE,4,BOISSY-SAINT-LEGER,7362,6231,5979,3414,2565
94,VAL-DE-MARNE,11,BONNEUIL-SUR-MARNE,8064,6289,5985,4004,1981
94,VAL-DE-MARNE,15,BRY-SUR-MARNE,8729,7150,6885,3070,3815
94,VAL-DE-MARNE,16,CACHAN,13802,11617,11137,6491,4646
94,VAL-DE-MARNE,17,CHAMPIGNY-SUR-MARNE,42778,32614,31193,18761,12432
94,VAL-DE-MARNE,18,CHARENTON-LE-PONT,13983,11632,11246,5389,5857
94,VAL-DE-MARNE,19,CHENNEVIERES-SUR-MARNE,8740,7408,7153,3444,3709
94,VAL-DE-MARNE,21,CHEVILLY-LARUE,9505,8084,7753,4572,3181
94,VAL-DE-MARNE,22,CHOISY-LE-ROI,19269,15748,15130,9381,5749
94,VAL-DE-MARNE,28,CRETEIL,41944,35504,34243,20669,13574
94,VAL-DE-MARNE,33,FONTENAY-SOUS-BOIS,33020,24841,23843,12922,10921
94,VAL-DE-MARNE,34,FRESNES,13712,11299,10864,6454,4410
94,VAL-DE-MARNE,37,GENTILLY,9994,7733,7362,5003,2359
94,VAL-DE-MARNE,38,L'HAY-LES-ROSES,17933,15283,14736,8502,6234
94,VAL-DE-MARNE,41,IVRY-SUR-SEINE,29044,22845,21786,15182,6604
94,VAL-DE-MARNE,42,JOINVILLE-LE-PONT,10439,8532,8532,4138,4394
94,VAL-DE-MARNE,43,LE KREMLIN-BICETRE,10282,8445,8110,4749,3361
94,VAL-DE-MARNE,44,LIMEIL-BREVANNES,8132,6875,6575,3811,2764
94,VAL-DE-MARNE,46,MAISONS-ALFORT,32059,27459,26400,13571,12829
94,VAL-DE-MARNE,52,NOGENT-SUR-MARNE,16224,13978,13587,5071,8516
94,VAL-DE-MARNE,54,ORLY,12704,9393,9029,6203,2826
94,VAL-DE-MARNE,58,LE PERREUX-SUR-MARNE,18091,15326,14767,6354,8413
94,VAL-DE-MARNE,59,LE PLESSIS-TREVISE,7620,6530,6287,3153,3134
94,VAL-DE-MARNE,60,LA QUEUE-EN-BRIE,5548,4744,4563,2575,1988
94,VAL-DE-MARNE,67,SAINT-MANDE,13408,11017,10750,3809,6941
94,VAL-DE-MARNE,68,SAINT-MAUR-DES-FOSSES,47996,40691,39468,15501,23967
94,VAL-DE-MARNE,71,SUCY-EN-BRIE,15109,13126,12640,5761,6879
94,VAL-DE-MARNE,73,THIAIS,14109,12028,11545,6461,5084
94,VAL-DE-MARNE,74,VALENTON,5678,4379,4146,2849,1297
94,VAL-DE-MARNE,76,VILLEJUIF,26168,20739,19746,13299,6447
94,VAL-DE-MARNE,77,VILLENEUVE-LE-ROI,11957,9274,8880,5536,3344
94,VAL-DE-MARNE,78,VILLENEUVE-SAINT-GEORGES,15371,12671,12139,7685,4454
94,VAL-DE-MARNE,79,VILLIERS-SUR-MARNE,12758,10733,10266,5786,4480
94,VAL-DE-MARNE,80,VINCENNES,28950,23831,23117,10010,13107
94,VAL-DE-MARNE,81,VITRY-SUR-SEINE,43901,34982,33479,22708,10771
95,VAL-D'OISE,18,ARGENTEUIL,50631,40381,38558,24745,13813
95,VAL-D'OISE,19,ARNOUVILLE-LES-GONESSE,7764,6387,6112,3396,2716
95,VAL-D'OISE,63,BEZONS,13256,10394,9853,6618,3235
95,VAL-D'OISE,127,CERGY,15553,12900,12429,7332,5097
95,VAL-D'OISE,176,CORMEILLES-EN-PARISIS,10410,8898,8536,4353,4183
95,VAL-D'OISE,197,DEUIL-LA-BARRE,11758,9537,9165,4153,5012
95,VAL-D'OISE,199,DOMONT,8058,6996,6709,3581,3128
95,VAL-D'OISE,203,EAUBONNE,15760,12901,12429,6035,6394
95,VAL-D'OISE,210,ENGHIEN-LES-BAINS,6994,6041,5889,1809,4080
95,VAL-D'OISE,218,ERAGNY,8373,6917,6598,4012,2586
95,VAL-D'OISE,219,ERMONT,16333,13515,13030,6965,6065
95,VAL-D'OISE,252,FRANCONVILLE,19064,15998,15352,8510,6842
95,VAL-D'OISE,268,GARGES-LES-GONESSE,17311,12241,11744,7951,3793
95,VAL-D'OISE,277,GONESSE,12184,9697,9255,5153,4102
95,VAL-D'OISE,280,GOUSSAINVILLE,12591,10524,10047,6369,3678
95,VAL-D'OISE,306,HERBLAY,12548,10987,10482,5710,4772
95,VAL-D'OISE,313,L'ISLE-ADAM,6532,5577,5398,2252,3146
95,VAL-D'OISE,424,MONTIGNY-LES-CORMEILLES,8429,6954,6649,3858,2791
95,VAL-D'OISE,428,MONTMORENCY,13053,11078,10756,4454,6302
95,VAL-D'OISE,476,OSNY,6625,5587,5322,3055,2267
95,VAL-D'OISE,487,PERSAN,4858,3807,3577,2530,1047
95,VAL-D'OISE,500,PONTOISE,15214,12152,11709,6045,5664
95,VAL-D'OISE,539,SAINT-BRICE-SOUS-FORET,5753,4782,4594,2555,2039
95,VAL-D'OISE,555,SAINT-GRATIEN,13074,10508,10171,5536,4635
95,VAL-D'OISE,563,SAINT-LEU-LA-FORET,8608,7405,7167,3482,3685
95,VAL-D'OISE,572,SAINT-OUEN-L'AUMONE,9404,7486,7196,4153,3043
95,VAL-D'OISE,582,SANNOIS,14333,11502,11001,5982,5019
95,VAL-D'OISE,585,SARCELLES,26983,21972,21210,13907,7303
95,VAL-D'OISE,598,SOISY-SOUS-MONTMORENCY,9900,8331,8051,3820,4231
95,VAL-D'OISE,607,TAVERNY,14806,12209,11732,6132,5600
95,VAL-D'OISE,680,VILLIERS-LE-BEL,12201,9473,9088,5855,3233
